1111111111111111111
1222122222222212221
1211121112111211121
1222221222221222221
1112111112111112111
1222222212122222221
1211111212121111121
1212222222222222121
1211111112111111121
1222222212122222221
1211111112111111121
1222222223222222221
1211111212121111121
1212222212122222121
1212111112111112121
1222221222221222221
1211121112111211121
1222122222222212221
1111111111111111111