1111111111111111111
1222222221222222221  
1212111211121112121   
1212221222221222121 
1112121112111212111 
1212121222221212121 
1222121211121212221 
1212121221221212121 
1212122221222212121 
1211121111111211121 
1212122221222212121 
1212121221221212121 
1222121211121212221 
1212121222221212121 
1112121113111212111 
1212221222221222121 
1212111211121112121 
1222222221222222221 
1111111111111111111 






