1111111111111111111
1222212222222122221
1212111211121112121
1212221222221222121
1212121112111212121
1212121222221212121
1222121211121212221
1212121222221212121
1212121112111212121
1211122223222211121
1212121112111212121
1212121222221212121
1222121211121212221
1212121222221212121
1212121112111212121
1212221222221222121
1212111211121112121
1222212222222122221
1111111111111111111